NO amine.xpm

SO hello.xpm

EA .xpm

WE hiii.xpm

F 1,255,5

C 1,                 2,5

111111****
100011111111111
11111100N00000011
111111111111111111