NO amine.xpm

SO hello.xpm

EA salam.xpm

WE hiii.xpm

F 1,255,5

C 1,2,255

1111111

100N0101111111111
11111100000000001
111111111111111111