SO amine.xpm
NO amine.xpm
EA amine.xpm
WE amine.xpm                      


F 1,2,3
C 1,2,3

1111111
1000N11
1111111                                                                                     

                                                            