SO amine.xpm
NO amine.xpm
EA amine.xpm
WE amine.xpm                      


F 1,2,3
C 1,2,3

11111111
100N0001
11111111
