NO  texc.xpm

SO  texc.xpm

WE texc.xpm

EA  test.xpm

F  1,2,3

C  1,2,3

             11111111111111111111111111111111111111111      
            100000000000000000001
    1111111110000111111111
1111111111111111111
