SO amine.xpm
NO amine.xpm
EA amine.xpm
WE amine.xpm                      


F 1,2,3
C 1,2,3

111111111
10000N001
100000001
111111111