SO amine.xpm


NO amine.xpm


EA  amine.xpm


WE amine.xpm                      


F 1,2,3
C 1,2,9

11111111                              111
10000S01          111
11111111
