NO  texc.xpm
SO salam.xpm
EA amine.xpm
WE hello.xpm

F 1,2,3
C 1,2,3

                11111111111111111111111111111
        111111110000000000000000000011111111111111111
    111111111110000000000000000000000000000000000001
    111111111111111111111111111111111111111111
