NO     texc.xpm

SO    texc.xpm

WE texc.xpm

EA  test.xpm

F  1,2,3

C  1,2,3


             11111111111101111111111111111111111111111      
             10000000000000000000001
    11111111111111111111111
1111111111111111111