SO amine.xpm
NO amine.xpm
EA amine.xpm
WE amine.xpm                      


F 1,2,3
C 1,2,3

111111
100N01
100001
111111